1111111111
0100101001
0101101011
0101101011
1111111111
1111111111
0100101001
0101101011
0101101011
1111111111